20 20
####################
#S                S#
##### ########### ##
##### # ### ##### ##
##         +##### ##
####### ###      S##
####   G  ###### ###
#######       ## +##
#S#####  #  ########
#          H       #
################## #
#       +         S#
################## #
#       H          #
###### #############
###### ######+######
###### ###### ######
###### ###### ######
#         H      G C
####################
